32
32
55555555555555555555555555555555
55555555555555555555555555555555
55555555555555555555555555555555
55555555555555555555555555555555
55553333333333333333333333335555
55553333333333333333333333335555
55553333333333333333333333335555
55553333333333333333333333335555
55553333344333333333333333335555
55553333334433333333333333335555
55553333333344333333333333335555
55553333333334433333333333335555
55553333333333443333333333335555
55553333333333334433333333335555
55553333333333333333333333335555
55553333333333333333333333335555
55553333333333333333333333335555
55553333333333333333333333335555
55553333333333333333333333335555
55553333333333333333333333335555
55553333333333333333333333335555
55553333333333333333333333335555
55553333333333333333333333335555
55553333333333333333333333335555
55553333333333333333333333335555
55553333333333333333333333335555
55553333333333333333333333335555
55553333333333333333333333335555
55555555555555555555555555555555
55555555555555555555555555555555
55555555555555555555555555555555
55555555555555555555555555555555
