20
20
11111111111111111111
1>>>>>>>>>>>>>>>>>>1
1>>>>>>>>>2>>>>>>>>1
1>>>>>>>>>6>>>>>>>>1
1>>>>>>>>>6>>>>>>>>1
1>>>>>>>>>6>>>>>>>>1
1>>>>>>>>>6>>>>>>>>1
1>>>>>>>>>6>>>>>>>>1
1>>>>>>>>>6>>>>>>>>1
1>>>>>>>>>6>>>>>>>>1
11111111110111111111
10000000000000000001
10000000000000000001
10001111111111110001
10001111111111110001
10001111111111110001
10001111111111110001
10000000000000000001
10000000000000000001
11111111110111111111
